1111111111111111111111111111111111
1E1000000000000000000C000000000001
1110000000000000000000000000000001
1000000000000000000000000000000001
1P0000000C00C000000000000000000001
1111111111111111111111111111111111
