111111
1E0001
100001
100001
1P0001
111111

