1111111111111111111111111111111111
1E0000000000000000000C000000000001
1000010100100000000001000000000001
1000010010101010001001000C00010101
1P0000000C00C000000000000000000001
1111111111111111111111111111111111