1111111111111111111111111
1E0000000000000000000C001
100001010000V000000000001
1V000100V0000000C00010001
1P0000000C00C000000000001
1111111111111111111111111
