1111111111111111111111111
1E0000000000000000000C001
1000010100000000000000001
1000010000000000C00010001
1P0000000C00C000000000001
1111111111111111111111111
