1111111111111111111111111
111111110000000000000C001
111111C100000000000000001
1000000000000000C00000001
10000000000E0000000000001
100000000000000100000C001
1011111111000000000000001
10000000C1000000C00010001
111111111100C000000000001
100000P000000000000000001
100000001C11C100000000001
1111111111111111111111111
