1111111111111111111111111111111111
1E00V0000000000000000C000000000001
100001010010000000000V000000000001
1000010010101010001001000C00010101
1P0000000C00C0000000V0000000000001
1111111111111111111111111111111111
